1011010100000110110101000001
00
11010010101111111101001010111111
1110110010000011101100100000
1011010100000110110101000001
11000011111011100001111101
11000011111011100001111101
11010010101111111101001010111111
11000100111000001100010011100000
