00111111111011001111110011011101
00111111101100011111100110111011
00111111010011101111011010011100
00111110110001011111001110000100
00111110000101001111000001110100
00111101001111101110110101101100
00111100010000101110101001110001
00111011001000001110011110000011
00111001110110101110010010100011
00111000011100011110000111010101
00110110111001011101111100011001
00110101001101101101110001110010
00110011011001111101100111100001
00110001011110011101011101100111
00101111011010111101010100000110
00101101010000011101001010111111
00101010111110101101000010010101
00101000100110011100111010000111
00100110000111111100110010011001
00100011100011101100101011001010
00100000111001111100100100011011
00011110001010111100011110001111
00011011010111011100011000100110
00011000011111011100010011100000
00010101100011111100001110111110
00010010100101001100001011000010
00001111100011001100000111101100
00001100011111001100000100111011
00001001011001001100000010110010
00000110010001011100000001001111
00000011001000111100000000010100
00000000000000001100000000000000
11111100110111011100000000010100
11111001101110111100000001001111
11110110100111001100000010110010
11110011100001001100000100111011
11110000011101001100000111101100
11101101011011001100001011000010
11101010011100011100001110111110
11100111100000111100010011100000
11100100101000111100011000100110
11100001110101011100011110001111
11011111000110011100100100011011
11011100011100101100101011001010
11011001111000011100110010011001
11010111011001111100111010000111
11010101000001101101000010010101
11010010101111111101001010111111
11010000100101011101010100000110
11001110100001111101011101100111
11001100100110011101100111100001
11001010110010101101110001110010
11001001000110111101111100011001
11000111100011111110000111010101
11000110001001101110010010100011
11000100111000001110011110000011
11000011101111101110101001110001
11000010110000101110110101101100
11000001111011001111000001110100
11000001001110111111001110000100
11000000101100101111011010011100
11000000010011111111100110111011
11000000000101001111110011011101
00111111111110111111111001101110
00111111111011001111110011011101
00111111110100111111101101001011
00111111101100011111100110111011
00111111100001001111100000101011
00111111010011101111011010011100
00111111000011101111010100001111
00111110110001011111001110000100
00111110011100011111000111111011
00111110000101001111000001110100
00111101101011101110111011101111
00111101001111101110110101101100
00111100110001011110101111101101
00111100010000101110101001110001
00111011101101101110100011111000
00111011001000001110011110000011
00111010100000101110011000010001
00111001110110101110010010100011
00111001001010101110001100111010
00111000011100011110000111010101
00110111101011111110000001110101
00110110111001011101111100011001
00110110000100101101110111000011
00110101001101101101110001110010
00110100010100111101101100100110
00110011011001111101100111100001
00110010011101001101100010100001
00110001011110011101011101100111
00110000011101101101011000110011
00101111011010111101010100000110
00101110010110101101001111011111
00101101010000011101001010111111
00101100001000011101000110100110
00101010111110101101000010010101
00101001110011011100111110001010
00101000100110011100111010000111
00100111010111111100110110001100
00100110000111111100110010011001
00100100110110101100101110101101
00100011100011101100101011001010
00100010001111011100100111101110
00100000111001111100100100011011
00011111100010111100100001010001
00011110001010111100011110001111
00011100110001101100011011010110
00011011010111011100011000100110
00011001111011111100010101111110
00011000011111011100010011100000
00010111000010001100010001001010
00010101100011111100001110111110
00010100000100111100001100111011
00010010100101001100001011000010
00010001000100011100001001010010
00001111100011001100000111101100
00001110000001011100000110001111
00001100011111001100000100111011
00001010111100011100000011110010
00001001011001001100000010110010
00000111110101011100000001111100
00000110010001011100000001001111
00000100101101011100000000101101
00000011001000111100000000010100
00000001100100101100000000000101
00111111110100111111101101001011
00111111010011101111011010011100
00111110011100011111000111111011
00111101001111101110110101101100
00111011101101101110100011111000
00111001110110101110010010100011
00110111101011111110000001110101
00110101001101101101110001110010
00110010011101001101100010100001
00101111011010111101010100000110
00101100001000011101000110100110
00101000100110011100111010000111
00100100110110101100101110101101
00100000111001111100100100011011
00011100110001101100011011010110
00011000011111011100010011100000
00010100000100111100001100111011
00001111100011001100000111101100
00001010111100011100000011110010
00000110010001011100000001001111
00000001100100101100000000000101
11111100110111011100000000010100
11111000001010111100000001111100
11110011100001001100000100111011
11101110111011111100001001010010
11101010011100011100001110111110
11100110000100011100010101111110
11100001110101011100011110001111
11011101110000111100100111101110
11011001111000011100110010011001
11010110001100111100111110001010
11010010101111111101001010111111
11001111100010101101011000110011
11001100100110011101100111100001
11001001111011101101110111000011
11000111100011111110000111010101
11000101011111101110011000010001
11000011101111101110101001110001
11000010010100101110111011101111
11000001001110111111001110000100
11000000011111001111100000101011
11000000000101001111110011011101
11000000000001010000000110010010
11000000010011110000011001000101
11000000111100100000101011110001
11000001111011000000111110001100
11000011001110110001010000010011
11000100111000000001100001111101
11000110110101100001110011000110
11001001000110110010000011100111
11001011101011010010010011011010
11001110100001110010100010011001
11010001101001100010110000100001
11010101000001100010111101101011
11011000101000010011001001110100
11011100011100100011010100110110
11100000011101010011011110101111
11100100101000110011100111011010
11101000111110000011101110110110
11101101011011000011110100111110
11110001111110110011111001110001
11110110100111000011111101001110
11111011010010110011111111010011
