00101101010000011101001010111111
00000000000000001100000000000000
11010010101111111101001010111111
00111011001000001110011110000011
00101101010000011101001010111111
00011000011111011100010011100000
00011000011111011100010011100000
11010010101111111101001010111111
11000100111000000001100001111101
