00111110110001011111001110000100
00111011001000001110011110000011
00110101001101101101110001110010
00101101010000011101001010111111
00100011100011101100101011001010
00011000011111011100010011100000
00001100011111001100000100111011
00000000000000001100000000000000
11110011100001001100000100111011
11100111100000111100010011100000
11011100011100101100101011001010
11010010101111111101001010111111
11001010110010101101110001110010
11000100111000001110011110000011
11000001001110111111001110000100
00111111101100011111100110111011
00111110110001011111001110000100
00111101001111101110110101101100
00111011001000001110011110000011
00111000011100011110000111010101
00110101001101101101110001110010
00110001011110011101011101100111
00101101010000011101001010111111
00101000100110011100111010000111
00100011100011101100101011001010
00011110001010111100011110001111
00011000011111011100010011100000
00010010100101001100001011000010
00001100011111001100000100111011
00000110010001011100000001001111
00111101001111101110110101101100
00110101001101101101110001110010
00101000100110011100111010000111
00011000011111011100010011100000
00000110010001011100000001001111
11110011100001001100000100111011
11100001110101011100011110001111
11010010101111111101001010111111
11000111100011111110000111010101
11000001001110111111001110000100
11000000010011110000011001000101
11000100111000000001100001111101
11001110100001110010100010011001
11011100011100100011010100110110
11101101011011000011110100111110
